#####################
#.........#.........#
#*##.####.#.####.##*#
#.## ####.#.####.##.#
#...................#
#.##.#.#######.#.##.#
#....#....#....#....#
####.#### # ####.####
   #.#         #.#   
####.# ###=### #.####
    .  #PBRIC#  .    
####.# ####### #.####
   #.#         #.#   
####.# ####### #.####
#.........#.........#
#.##.####.#.####.##.#
#*.#......M......#.*#
##.#.#.#######.#.#.##
#....#....#....#....#
#.#######.#.#######.#
#...................#
#####################
