#####################
#         #         #
# ## #### # #### ## #
# ## #### # #### ## #
#                   #
# ## # ####### # ## #
#    #    #    #    #
#### #### # #### ####
   # #         # #   
#### # ### ### # ####
       #     #       
#### # ####### # ####
   # #         # #   
#### # ####### # ####
#         #         #
# ## #### # #### ## #
#  #             #  #
## # # ####### # # ##
#    #    #    #    #
# #######   ####### #
#                   #
#####################
